0,200,400,600,800,1000,1200,1400,1600,1800,2000,2200,2400,2600,2800,3000,3200,3400,1000,0,0
250,350,450,550,650,750,850,950,1050,1150,1250,1350,1450,1550,1650,1750,1850,1950,2050,2150,500
500,600,700,800,900,1000,1100,1200,1300,1400,1500,1600,1700,1800,1900,2000,2100,2200,2300,2400,1000
750,850,950,1050,1150,1250,1350,1450,1550,1650,1750,1850,1950,2050,2150,2250,2350,2450,2550,2650,1500
1000,1100,1200,1300,1400,1500,1600,1700,1800,1900,2000,2100,2200,2300,2400,2500,2600,2700,2800,2900,2000
1250,1350,1450,1550,1650,1750,1850,1950,2050,2150,2250,2350,2450,2550,2650,2750,2850,2950,3050,3150,2500
1500,1600,1700,1800,1900,2000,2100,2200,2300,2400,2500,2600,2700,2800,2900,3000,3100,3200,3300,3400,3000
1750,1850,1950,2050,2150,2250,2350,2450,2550,2650,2750,2850,2950,3050,3150,3250,3350,3450,3550,3650,3500